NO textures/eclipsecouleur.xpm
SO textures/eclipsecouleur.xpm
WE textures/eclipsecouleur.xpm
EA textures/eclipsecouleur.xpm

F 255,255,255
C 135,206,250

111111111111111111111111111111111111111111111111111111111111111111111
111111111111111111111111111100000000010000000000000000000000011111111
100000000000000000000000000100000000010000000000000000000011110000001
100000000000B00000000000000P000000000P000000000000000000000B0P0000001
1111111111111111111111111111111111P1111111111111111111111111111111111
                               1000001
                               1000001
                               1000001
                               1000001
                               1000001
                               1000001
                               1000001
                               1000001
111111111111111111111111111111 1000001 111111111111111111111111111111
1B0000000000000010000000000001 1000001 1000000000000100000000000000B1
1B00000000000000100000000000011100000111000000000000100000000000000B1
1B00000000000000P00000000000000P00000P00000000000000P00000000000000B1
1B00000000000000100000000000011100000111000000000000100000000000000B1
1B0000000000000010000000000001 1000001 1000000000000100000000000000B1
111111111111111111111111111111 1000001 111111111111111111111111111111
                               1000001
                               1000001
                               1000001
                               1000001
                               1000001
                               1000001
                               1000001
                               1000001
                               100N001
                               1111111
