NO textures/doom/stone.xpm
SO textures/doom/stone.xpm
WE textures/doom/stone.xpm
EA textures/doom/stone.xpm

C textures/skybox/skybox_desert_night.xpm
F 255,255,255

1111111111111111111111111
1111111111111111111111111
1000000000001111111111111
1000000000001111110000001
1000000000000000010000001
1000000000000000010000001
10000000000011100P0000001111111111
1000000000001111110000000000000001
1000000000001111111111111010111001
1000000000001100010000011010111001
1000000000001100000000011010111001
10000000000B1100010000010000011101
100011P1111111000100000100000000011111111111111111111
10B01100011111000100B00100000111011100000111111111111
10001100000011000111111100000000011100000111111111111
11111111000011000000000000000111011100000100000011111
11111111000011000000000000000000000100000000000011111
11100P00000011000000000000000111100P0000B100000011111
11000100000011111100001010101111111111111111100011111
11000100000011000100001010101111100000000000100000001
11000111111111000100001010101110100000000000100000001
11000111111111000100001000000000100000000000100000001
11000000000B1110111001111111111P111110001101110110001
11000000000011000000011111100000000010001000000010001
11000000000011000000011111100000000010001000000010001
11000000000011000000011111100000000010001000000010001
1100000000001110000011111P000000000010001100000110001
11000000000011110001111111100000000010001110001110001
11B000000000P001000111111110000000001111111000110000011111111111
1111111111111001000111111110000000001111111000100000001111111111
1111111111110001101111111111111011111111111101100000001111111111
100000000000000100011111111111000111111111100010000000101B101B11
1000000000000001000111111111110001111111111000110111011010101011
1000000000000001000111111111100000111111111000100000000000000001
1000000000000001000000000010000000001000000000100000000000000001
1000000000000001000000000000000B00000000000000100000000000000001
1000000000000001000000000010000000001000000000111111111010101011
1000000001111111111111111111111011111111111111111111111B101B1011
111111P111100000000011111111110001111111110000000001111111111111
110000011100000000001111111111000111111111000000000011
1100B0011110000000001111111110000011111111000000000111
110000111100001110000001000000000000001000000111000011
11P1111111100011100000000000000B0000000000000111000111
10011B001100001110000001000000000000001000000111000011
100110001110000000001111111110000011111111000000000111
101000001100000000001111111111000111111111000000000011
10101111111000000000111101111100011110111100000000B111
101011111111110001111001B100011011001B1001110001111111
101011111111110001111000000001000100000001110001
101000000111110001111000000001000100000001110001
101111110111110001111000000001000100000001110001
1000B0000111110001111000000001000100000001110001
111111111111110001111000000000000000000001110001
             10001111000000001000100000001110001
             10001111111111P11111111111111110001
             10001111111111000111111111111110001
             10001110000B11B0011111111B000110001
             10001110000011111111111110000110001
             10001110000111111111111111000110001
             100000000000000000000000000000W0001
             10000000000000000000000000000000001
             11111111111111111111111111111111111