NO textures/eclipsecouleur.xpm
SO textures/eclipsecouleur.xpm
WE textures/eclipsecouleur.xpm
EA textures/eclipsecouleur.xpm

F 255,255,255
C 135,206,250

111111111111111111111111111111111111111111111111111111111
111111111111PPPPPPPPPPPP111111111111111111111111111111111
111111111111PP1111111PP1111111111111111111111111111111111
1PPPPPPPPPPPPPPPPPPPPPPPPPPPPPPPPPPPPP1PPPPP1PP1PPPPP1PP1
1PPPPPPPPPPPPPPPPPPPPPPPPPPPPPPPPPPPPP1PP1PP1PP1PP1PP1PP1
1P1P1P1P1P1P1PPPPPP1P1P1P1P1PPPPPPPPPP1PP1PP1PP1PP1PP1PP1
1PPPPPPPPPPPPPPPPPPPPPPPPPPPPPPPPPPPPP1PP1PP1PP1PP1PP1PP1
1PPPPPPPPPPPPPPPPPPP1PPPPP1PPPPPPPPPPP1PP1PP1PP1PP1PP1PP1
1PPPPPPPPPPPPPPPPPPPPPPPPPPPPPPPPPPPPP1PP1PP1PP1PP1PP1PP1
1PPPPPPPP11PPP11PPPPP1PPP1PPPPPPPPPPPP1PP1PP1PP1PP1PP1PP1
1PPPPPPPP1PPPPP1PPPPPPPPPPPPPPPPPPPPPP1PP1PP1PP1PP1PP1PP1
1PPPPPPPPPPPPPPPPPPPPP1P1PPPPPPPPPPPPP1PP1PP1PP1PP1PP1PP1
1PPPPPPPPPPPPPPPPPPPPPPPPPPPPPPPPPPPPP1PP1PP1PP1PP1PP1PP1
1PPPPPPPPPPPPPPPPPPPPPP1PPPPPPPPPPPPPP1PP1PP1PP1PP1PP1PP1
1PPPPPPPP1PPPPP1PPPPPPPPPPPPPP11P11P111111111111111111111111111111111111111111111111111111111111111111111111111
1PPPPPPPP11PPP11PPPPPPPPPPPPPPPPPPPPPPPPPPPPPPPPPPPPPPPPPPPPPPPPPPPPPPPPPPPPPPPPPPPPPPPPPPPPPPPPPPPPPPPPPPPPPP1
1PPPPPPPPPPPPPPPPPPPPPPPPPPPPP11P11P111111111111111111111111111111111111111111111111111111111111111111111111111
1PPPPPPPPPPPPPPPPPPPPPPPPPPPPPPPPPPPPP1PP1PP1PP1PP1PP1PP1111111111111111111111111111111111111111111111111111111
1PPPPPPPP11PPP11PPPPP1PPP1PPPPPPPPPPPP1PP1PPPPP1PP1PP1PPPPPPPPPPPPPPPPPPPPPPPPPPPPPPPPPPPPPPPPPPPPPPPPPPPPPPPP1
1PPPPPPPP1PPPPP1PPPPPPPPPPPPPPPPPPPPPP1PP1PP1PP1PP1PP1PP11111111111111111111111111111111111111111111111111111P1
1PPPPPPPPPPPPPPPPPPPPP1P1PPPPPPPPPPPPP1PP1PP1PP1PP1PP1PP1                                                   1P1
1PPPPPPPPPPPPPPPPPPPPPPPPPPPPPPPPPPPPP1PP1PP1PP1PP1PP1PP1                                                   1P1
1PPPPPPPPPPPPPPPPPPPPPP1PPPPPPPPPPPPPPPPP1PP1PPPPP1PPPPP1                                                   1P1
1PPPPPPPP1PPPPP1PPPPPPPPPPPPPP11P11P1111111111111111111111111111111111111111111111111111111111111111111111111P1
1PPPPPPPP11PPP11PPPPPPPPPPPPPPPPPPPPPPPPPPPPPPPPPPPPPPPPPPPPPPPPPPPPPPPPPPPPPPPPPPPPPPPPPPPPPPPPPPPPPPPPPPPPPP1
1PPPPPPPPPPPPPPPPPPPPPPPPPPPPP11P11P1111111111111111111111111111111111111111111111111111111111111111111111111P1
1PPPPPPPPPPPPPPPPPPPPPPPPPPPPPPPPPPPPPPPP1PP1PPPPP1PPPPP1                                                   1P1
1PPPPPPPPPPPPPPPPP1PPPPPPPPPPPPPPPPPPP1PP1PP1PP1PP1PP1PP1                                                   1P1
1PPPPPPPPPPPPPPPPPP1PPPPPPPPPPPPPPPPPP1PP1PP1PP1PP1PP1PP1                                                   1P1
1PPPPPPPPPPPPPPPPPPPPPPPPPPPPPPPPPPPPP1PP1PP1PP1PP1PP1PP11111111111111111111111111111111111111111111111111111P111111
1PPPPPPPPPPPPPPPPPPPPPPPPPPPPPPPPPPPPP1PP1PPPPP1PP1PP1PPPPPPPPPPPPPPPPPPPPPPPPPPPPPPPPPPPPPPPPPPPPPPPPPPPPPPPPPPPPPP1
1PPPPPPPPPPPPPPPPPPPPPPPPPPPPPPPPPPPPP1PP1PP1PP1PP1PP1PP111111111111111111111111111111111111111111111111111111111111
1PPPPPPPPPPPPPPPPPPPPPPPPPPPPPPPPPPPPP1PP1PP1PP1PP1PP1PP1
1PPPPPPPPPPPPPPPPPPPPPPPPPPPPPPPPPPPPP1PP1PP1PP1PP1PP1PP1
1PPPPPPPPPPPPPPPPPPPPPPPPPPPPPPPPPPPPP1PP1PP1PP1PP1PP1PP1
1PPPPNPPPPPPPPPPPPPPPPBPPPPPPPPPPPPPP1PP1PP1PP1PP1PP1PP1
1PPPPPPPPPPPPPPPPPPPPPPPPPPPPPPPPPPPPP1PP1PP1PP1PP1PP1PP1
1PPPPPPPPPPPPPPPPPPPPPPPPPPPPPPPPPPPPP1PP1PP1PP1PP1PP1PP1
1PPPPPPPPPPPPPPPPPPPPPPPPPPPPPPPPPPPPP1PP1PP1PP1PP1PP1PP1
1PPPPPPPPPPPPPPPPPPPPPPPPPPPPPPPPPPPPP1PP1PP1PP1PP1PP1PP1
1PPPPPPPPPPPPPPPPPPPPPPPPPPPPPPPPPPPPP1PP1PP1PP1PP1PP1PP1
1PPPPPPPPPPPPPPPPPPPPPPPPPPPPPPPPPPPPP1PP1PP1PP1PP1PP1PP1
1PPPPPPPPPPPP11111111111PP11111111P1111111111111111111111
1P1111P1111111PPPPPPPP111111111111P1111111111111111111111
111111111111111111111111111111111P11111111111111111111111
                               1PPPPP1
                               1PPPPP1
                               1PPPPP1
                               1PPPPP1
                               1PPPPP1
                               1PPPPP1
                               1PPPPP1
                               1PPPPP1
111111111111111111111111111111 1PPPPP1 111111111111111111111111111111
1PPPPPPPPPPPPPPPPPPPPPPPPPPPP1 1PPPPP1 1PPPPPPPPPPPPPPPPPPPPPPPPPPPP1
1PPPPPPPPPPPPPPPPPPPPPPPPPPPP111PPPPP111PPPPPPPPPPPPPPPPPPPPPPPPPPPP1
1PPPPPPPPPPPPPPPPPPPPPPPPPPPPPPPPPPPPPPPPPPPPPPPPPPPPPPPPPPPPPPPPPPP1
1PPPPPPPPPPPPPPPPPPPPPPPPPPPP111PPPPP111PPPPPPPPPPPPPPPPPPPPPPPPPPPP1
1PPPPPPPPPPPPPPPPPPPPPPPPPPPP1 1PPPPP1 1PPPPPPPPPPPPPPPPPPPPPPPPPPPP1
111111111111111111111111111111 1PPPPP1 111111111111111111111111111111
                               1PPPPP1
                               1PPPPP1
                               1PPPPP1
                               1PPPPP1
                               1PPPPP1
                               1PPPPP1
                               1PPPPP1
                               1PPPPP1
                               1PPPPP1
                               1111111



