NO ./path_to_the_north_texture.xpm
SO ./path_to_the_south_texture.xpm
WE ./path_to_the_west_texture.xpm
EA ./path_to_the_east_texture.xpm

F 220,210,0
C 225,30,0

111111111111111111111111111111
111111111111000000000000111111
111111111111001111111001111111
100000000000000000000000000001
100000000000000000000000000001
101010101010100000010101010101
100000000000000000000000000001
10000000000000N000000000000001
100000000000000000000000000001
100000000000000000000000000001
100000000000000000000000000001
100000000000011111111111001111
101111111111110000000011111111
111111111111111111111111111111