NO ./path_to_the_north_texture.xpm
SO ./path_to_the_south_texture.xpm
WE ./path_to_the_west_texture.xpm
EA ./path_to_the_east_texture.xpm

F 220,210,0
C 225,30,0

111111111111111111111111111111111111111111111111111111111
111111111111000000000000111111111111111111111111111111111
111111111111001111111001111111111111111111111111111111111
100000000000000000000000000001000001001000001001000001001
100000000000000000000000000001001001001001001001001001001
101010101010100000010101010101001001001001001001001001001
100000000000000000000000000001001001001001001001001001001
100000000000000000001000001001001001001001001001001001001
100000000000000000000000000001001001001001001001001001001
100000000110001100000100010001001001001001001001001001001
100000000100000100000000000001001001001001001001001001001
100000000000000000000010100001001001001001001001001001001
100000000000000000000000000001001001001001001001001001001
100000000000000000000001000001001001001001001001001001001
100000000100000100000000000001111111111111111111111111111111111111111111111111111111111111111111111111111111111
100000000110001100000000000000000000000000000000000000000000000000000000000000000000000000000000000000000000001
100000000000000000000000000001111111111111111111111111111111111111111111111111111111111111111111111111111111111
100000000000000000000000000001001001001001001001001001001111111111111111111111111111111111111111111111111111111
100000000110001100000100010001001000001001000001001001000000000000000000000000000000000000000000000000000000001
100000000100000100000000000001001001001001001001001001001111111111111111111111111111111111111111111111111111101
100000000000000000000010100001001001001001001001001001001                                                   101
100000000000000000000000000001001001001001001001001001001                                                   101
100000000000000000000001000001001001000001001000001000001                                                   101
100000000100000100000000000001111111111111111111111111111111111111111111111111111111111111111111111111111111101
100000000110001100000000000000000000000000000000000000000000000000000000000000000000000000000000000000000000001
100000000000000000000000000001111111111111111111111111111111111111111111111111111111111111111111111111111111101
100000000000000000000000000001000001000001001000001000001                                                   101
100000000000000000100000000001001001001001001001001001001                                                   101
100000000000000000010000000001001001001001001001001001001                                                   101
100000000000000000000000000001001001001001001001001001001111111111111111111111111111111111111111111111111111101111111111111111111111111111111111111111111111111111111111111111111111111111111111111111111111111111111111111111111111111111111111111111111111111111111111111111111111111111111111111111111111111111111111111111111111111111111111111111111111111111111111111111111111111111111111111111111111111111111111111111111
1000000000000000000000000000010010000010010000010010010000000000000000000000000000000000000000000000000000000000000000000000000000000000000000000000000000000000000000000000000000000000000000000000000000000000000000000000000000000000000000000000000000000000000000000000000000000000000000000000000000000000000000000000000000000000000000000000000000000000000000000000000000000000000000000000000000000000000000000000000001
100000000000000000000000000001001001001001001001001001001111111111111111111111111111111111111111111111111111111111111111111111111111111111111111111111111111111111111111111111111111111111111111111111111111111111111111111111111111111111111111111111111111111111111111111111111111111111111111111111111111111111111111111111111111111111111111111111111111111111111111111111111111111111111111111111111111111111111111111111111
100000000000000000000000000001001001001001001001001001001
100000000000000000000000000001001001001001001001001001001
100000000000000000000000000001001001001001001001001001001
1000N0000000000000000000000001001001001001001001001001001
100000000000000000000000000001001001001001001001001001001
100000000000000000000000000001001001001001001001001001001
100000000000000000000000000001001001001001001001001001001
100000000000000000000000000001001001001001001001001001001
100000000000000000000000000001001001001001001001001001001
100000000000000000000000000001001001001001001001001001001
100000000000011111111111001111111111111111111111111111111
101111111111110000000011111111111111111111111111111111111
111111111111111111111111111111111111111111111111111111111




