NO textures/ceilingrocks.xpm
SO textures/ceilingrocks.xpm
WE textures/ceilingrocks.xpm
EA textures/ceilingrocks.xpm

F 0,0,0
C 0,0,0

111111111111111111111111111111111111111111111111111111111
111111111111000000000000111111111111111111111111111111111
111111111111001111111001111111111111111111111111111111111
100000000000000000000000000000000000001000001001000001001
100000000000000000000000000000000000001001001001001001001
101010101010100000010101010100000000001001001001001001001
100000000000000000000000000000000000001001001001001001001
100000000000000000001000001000000000001001001001001001001
100000000000000000000000000000000000001001001001001001001
100000000110001100000100010000000000001001001001001001001
100000000100000100000000000000000000001001001001001001001
100000000000000000000010100000000000001001001001001001001
100000000000000000000000000000000000001001001001001001001
100000000000000000000001000000000000001001001001001001001
100000000100000100000000000000110110111111111111111111111111111111111111111111111111111111111111111111111111111
100000000110001100000000000000000000000000000000000000000000000000000000000000000000000000000000000000000000001
100000000000000000000000000000110110111111111111111111111111111111111111111111111111111111111111111111111111111
100000000000000000000000000000000000001001001001001001001111111111111111111111111111111111111111111111111111111
100000000110001100000100010000000000001001000001001001000000000000000000000000000000000000000000000000000000001
100000000100000100000000000000000000001001001001001001001111111111111111111111111111111111111111111111111111101
100000000000000000000010100000000000001001001001001001001                                                   101
100000000000000000000000000000000000001001001001001001001                                                   101
100000000000000000000001000000000000000001001000001000001                                                   101
100000000100000100000000000000110110111111111111111111111111111111111111111111111111111111111111111111111111101
100000000110001100000000000000000000000000000000000000000000000000000000000000000000000000000000000000000000001
100000000000000000000000000000110110111111111111111111111111111111111111111111111111111111111111111111111111101
100000000000000000000000000000000000000001001000001000001                                                   101
100000000000000000100000000000000000001001001001001001001                                                   101
100000000000000000010000000000000000001001001001001001001                                                   101
10000000000000000000000000000000000000100100100100100100111111111111111111111111111111111111111111111111111110111111
100000000000000000000000000000000000001001000001001001000000000000000000000000000000000000000000000000000000000000001
10000000000000000000000000000000000000100100100100100100111111111111111111111111111111111111111111111111111111111111
100000000000000000000000000000000000001001001001001001001
100000000000000000000000000000000000001001001001001001001
100000000000000000000000000000000000001001001001001001001
10000N000000000000000000000000000000001001001001001001001
100000000000000000000000000000000000001001001001001001001
100000000000000000000000000000000000001001001001001001001
100000000000000000000000000000000000001001001001001001001
100000000000000000000000000000000000001001001001001001001
100000000000000000000000000000000000001001001001001001001
100000000000000000000000000000000000001001001001001001001
100000000000011111111111001111111101111111111111111111111
101111011111110000000011111111111101111111111111111111111
111111111111111111111111111111111011111111111111111111111
                               1000001
                               1000001
                               1000001
                               1000001
                               1000001
                               1000001
                               1000001
                               1000001
111111111111111111111111111111 1000001 111111111111111111111111111111
100000000000000000000000000001 1000001 100000000000000000000000000001
100000000000000000000000000001110000011100000000000000000000000000001
100000000000000000000000000000000000000000000000000000000000000000001
100000000000000000000000000001110000011100000000000000000000000000001
100000000000000000000000000001 1000001 100000000000000000000000000001
111111111111111111111111111111 1000001 111111111111111111111111111111
                               1000001
                               1000001
                               1000001
                               1000001
                               1000001
                               1000001
                               1000001
                               1000001
                               1000001
                               1111111



