NO ./path_to_the_north_texture.xpm
SO ./path_to_the_south_texture.xpm
WE ./path_to_the_west_texture.xpm
EA ./path_to_the_east_texture.xpm

F 220,210,0
C 225,30,0

111111111111111111111111111111
111111111111000000000000111111
111111111111001111111001111111
100000000000000000000000000001
100000000000000000000000000001
101010101010100000010101010101
100000000000000000000000000001
100000000000000000001000001001
100000000000000000000000000001
100000000110001100000100010001
1000000001000001000N0000000001
100000000000000000000010100001
100000000000000000000000000001
100000000000000000000001000001
100000000100000100000000000001
100000000110001100000000000001
100000000000000000000000000001
100000000000000000000000000001
100000000000000000000000000001
100000000000000000000000000001
100000000000000000000000000001
100000000000000000000000000001
100000000000000000000000000001
100000000000000000000000000001
100000000000000000000000000001
100000000000000000000000000001
100000000000000000000000000001
100000000000011111111111001111
101111111111110000000011111111
111111111111111111111111111111




1111111111111111111111111111111111111111111111111111111111111111111111111111111111
1111111111110000000000001111111111111111111111111111111111111111111111111111111111
1111111111110011111110011111111111111111111111111111111111111111111111111111111111
1000000000000000000000000000011111111111111111111111111111111111111111111111111111
1000000000000000000000000000011111111111111111111111111111111111111111111111111111
1010101010101000000101010101011111111111111111111111111111111111111111111111111111
1000000000000000000000000000011111111111111111111111111111111111111111111111111111
1000000000000000000010000010011111111111111111111111111111111111111111111111111111
1000000000000000000000000000011111111111111111111111111111111111111111111111111111
1000000001100011000001000100011111111111111111111111111111111111111111111111111111
1000000001000001000N00000000011111111111111111111111111111111111111111111111111111
1000000000000000000000101000011111111111111111111111111111111111111111111111111111
1000000000000000000000000000011111111111111111111111111111111111111111111111111111
1000000000000000000000010000011111111111111111111111111111111111111111111111111111
1000000001000001000000000000011111111111111111111111111111111111111111111111111111
1000000001100011000000000000011111111111111111111111111111111111111111111111111111
1000000000000000000000000000011111111111111111111111111111111111111111111111111111
1000000000000000000000000000011111111111111111111111111111111111111111111111111111
1000000000000000000000000000011111111111111111111111111111111111111111111111111111
1000000000000000000000000000011111111111111111111111111111111111111111111111111111
1000000000000000000000000000011111111111111111111111111111111111111111111111111111
1000000000000000000000000000011111111111111111111111111111111111111111111111111111
1000000000000000000000000000011111111111111111111111111111111111111111111111111111
1000000000000000000000000000011111111111111111111111111111111111111111111111111111
1000000000000000000000000000011111111111111111111111111111111111111111111111111111
1000000000000000000000000000011111111111111111111111111111111111111111111111111111
1000000000000000000000000000011111111111111111111111111111111111111111111111111111
1000000000000111111111110011111111111111111111111111111111111111111111111111111111
1011111111111100000000111111111111111111111111111111111111111111111111111111111111
1111111111111111111111111111111111111111111111111111111111111111111111111111111111
1111111111111111111111111111111111111111111111111111111111111111111111111111111111
1111111111111111111111111111111111111111111111111111111111111111111111111111111111
1111111111111111111111111111111111111111111111111111111111111111111111111111111111
1111111111111111111111111111111111111111111111111111111111111111111111111111111111
1111111111111111111111111111111111111111111111111111111111111111111111111111111111
1111111111111111111111111111111111111111111111111111111111111111111111111111111111
1111111111111111111111111111111111111111111111111111111111111111111111111111111111
1111111111111111111111111111111111111111111111111111111111111111111111111111111111
1111111111111111111111111111111111111111111111111111111111111111111111111111111111
1111111111111111111111111111111111111111111111111111111111111111111111111111111111
1111111111111111111111111111111111111111111111111111111111111111111111111111111111
1111111111111111111111111111111111111111111111111111111111111111111111111111111111
1111111111111111111111111111111111111111111111111111111111111111111111111111111111
1111111111111111111111111111111111111111111111111111111111111111111111111111111111
1111111111111111111111111111111111111111111111111111111111111111111111111111111111
1111111111111111111111111111111111111111111111111111111111111111111111111111111111
1111111111111111111111111111111111111111111111111111111111111111111111111111111111
1111111111111111111111111111111111111111111111111111111111111111111111111111111111
1111111111111111111111111111111111111111111111111111111111111111111111111111111111
1111111111111111111111111111111111111111111111111111111111111111111111111111111111
1111111111111111111111111111111111111111111111011111110111111111111111111111111111
1111111111111111111111111111111111111111111111101111101111111111111111111111111111
1111111111111111111111111111111111111111111111110111011111111111111111111111111111
1111111111111111111111111111111111111111111000001111100000111111111111111111111111
1111111111111111111111111111111111111111111000001111100000111111111111111111111111
1111111111111111111111111111111111111111111000001111100000111111111111111111111111
1111111111111111111111111111111111111111111111111111111111111111111111111111111111
1111111111111111111111111111111111111111111111111111111111111111111111111111111111
1111111111111111111111111111111111111100000000000000000000000001111111111111111111
1111111111111111111111111111111111111100000000000000000000000001111111111111111111
1111111111111111111111111111111111111100000000000000000000000001111111111111111111
1111111111111111111111111111111111111111111111111111111111111111111111111111111111
1111111111111111111111111111111111111111111111111111111111111111111111111111111111
1111111111111111111111111111111111111111111111111111111111111111111111111111111111
1111111111111111111111111111111111111111111111111111111111111111111111111111111111
1111111111111111111111111111111111111111111111111111111111111111111111111111111111
1111111111111111111111111111111111111111111111111111111111111111111111111111111111
1111111111111111111111111111111111111111111111111111111111111111111111111111111111
1111111111111111111111111111111111111111111111111111111111111111111111111111111111
1111111111111111111111111111111111111111111111111111111111111111111111111111111111
1111111111111111111111111111111111111111111111111111111111111111111111111111111111
1111111111111111111111111111111111111111111111111111111111111111111111111111111111
1111111111111111111111111111111111111111111111111111111111111111111111111111111111
1111111111111111111111111111111111111111111111111111111111111111111111111111111111
1111111111111111111111111111111111111111111111111111111111111111111111111111111111