NO textures/s.xpm
SO textures/s.xpm
WE textures/e.xpm
EA textures/e.xpm

F 0,0,0
C textures/skybox/skybox_desert_night.xpm

           1
11111111111S11111111
11111111000000011111
10000111100000011111
10000000000000011111
10000000000001111111
10001111111111111111
11111111111111111111



