NO textures/n.xpm
SO textures/s.xpm
WE textures/w.xpm
EA textures/e.xpm

F 220,210,0
C 225,30,0

11111111111111111111
11111111000000011111
10000111100000011111
10000000S00000011111
10000000000001111111
10001111111111111111
11111111111111111111